width = 5632
height = 2048

max_provinces = 2000
sea_starts = { 
	877 878 879 886 887 888 889 890 891 892 893 894 895 896 897 898 899 900 901 902 903 904 905 906 906 907 908 909 910 911 912 913 914 915 916 917 918 918
	919 920 920 921 922 923 924 925 926 926 927 928 929 930 931 932 933 934 935 936 937 937 938 939 940 941 942 943 944 945 945 946 947 948 948 949 950 951 
	952 952 953 954 955 956 957 960 961 962 964 965 966 967 968 968 969 970 971 971 972 972 973 974 975 976 977 978 979 980 981 981 982 983 984 985 986 987 
	988 989 990 991 992 993 994 995 996 997 998 999 1000 1001 1001 1002 1003 1004 1005 1007 1008 1009 1010 1011 1012 1013 1014 1015 1016 1017 1018 1019 1020 
	1021 1022 1023 1024 1025 1026 1027 1028 1029 1030 1031 1032 1033 1034 1035 1036 1037 1038 1039 1040 1041 1042 1043 1044 1045 1046 1047 1048 1049 1050 
	1051 1052 1053 1054 1055 1056 1057 1058 1059 1060 1060 1061 1062 1063 1064 1065 1066 1067 1068 1069 1070 1071 1072 1073 1074 1075 1076 1078 1082 1083 
	1095 1096 1097 1098 1098 1098 1099 1100 1101 1102 1103 1104 1105 1106 1107 1108 1109 1110 1111 1112 1113 1114 1115 1116 1117 1118 1119 1120 1121 1122 
	1123 1124 1125 1126 1127 1128 1129 1155 1156 1157 1158 1159 1160 
	1423 1424 1426 1427 1428 1429 1430 1431 1432 1433 1434 1435 1436 1437 1438 1439 1440
	1441 1442 1443 1444 1445 1446 1448 1449 1451 1441 1519 1520 1521 1522 1523 1524 1525 1526 1527 1528
	1530 1531 1533 1534 1535 1539 1540 1541 1542 1545 1546 1547 1548 1549 1550
	1551 1552 1553 1554 1555 1556 1557 1558 1560 1561 1562 1563 1564 1566 1567 1568 1570 1571
}

lakes = {
	882 883 881 884 885 
}

force_coastal = {
}

definitions = "definition.csv"
provinces = "provinces.bmp"
positions = "positions.txt"
terrain = "terrain.bmp"
rivers = "rivers.bmp"
terrain_definition = "terrain.txt"
heightmap = "heightmap.bmp"
tree_definition = "trees.bmp"
continent = "continent.txt"
adjacencies = "adjacencies.csv"
climate = "climate.txt"
region = "region.txt"
ambient_object = "ambient_object.txt"
seasons = "seasons.txt"
trade_winds = "trade_winds.txt"

# Define which indices in trees.bmp palette which should count as trees for automatic terrain assignment
tree = { 3 4 7 10 }
